"filename", "language", "HTML", "JavaScript", "JSON", "Markdown", "comment", "blank", "total"
"d:\VUE-TEM-A-R-V-T\Readme.md", "Markdown", 0, 0, 0, 67, 0, 34, 101
"d:\VUE-TEM-A-R-V-T\ast.md", "Markdown", 0, 0, 0, 71, 0, 6, 77
"d:\VUE-TEM-A-R-V-T\dist\umd\vue.js", "JavaScript", 0, 384, 0, 0, 36, 119, 539
"d:\VUE-TEM-A-R-V-T\index.html", "HTML", 41, 0, 0, 0, 8, 3, 52
"d:\VUE-TEM-A-R-V-T\package.json", "JSON", 0, 0, 20, 0, 0, 1, 21
"d:\VUE-TEM-A-R-V-T\rollup.config.js", "JavaScript", 0, 14, 0, 0, 10, 1, 25
"d:\VUE-TEM-A-R-V-T\src\compiler\astParser.js", "JavaScript", 0, 99, 0, 0, 35, 28, 162
"d:\VUE-TEM-A-R-V-T\src\compiler\generate.js", "JavaScript", 0, 58, 0, 0, 18, 19, 95
"d:\VUE-TEM-A-R-V-T\src\compiler\index.js", "JavaScript", 0, 13, 0, 0, 3, 2, 18
"d:\VUE-TEM-A-R-V-T\src\index.js", "JavaScript", 0, 10, 0, 0, 1, 5, 16
"d:\VUE-TEM-A-R-V-T\src\init.js", "JavaScript", 0, 31, 0, 0, 1, 10, 42
"d:\VUE-TEM-A-R-V-T\src\lifecycle.js", "JavaScript", 0, 14, 0, 0, 2, 4, 20
"d:\VUE-TEM-A-R-V-T\src\observer\array.js", "JavaScript", 0, 34, 0, 0, 0, 7, 41
"d:\VUE-TEM-A-R-V-T\src\observer\index.js", "JavaScript", 0, 48, 0, 0, 0, 10, 58
"d:\VUE-TEM-A-R-V-T\src\state.js", "JavaScript", 0, 35, 0, 0, 0, 15, 50
"d:\VUE-TEM-A-R-V-T\src\utils.js", "JavaScript", 0, 30, 0, 0, 0, 4, 34
"d:\VUE-TEM-A-R-V-T\src\vdom\index.js", "JavaScript", 0, 23, 0, 0, 1, 8, 32
"d:\VUE-TEM-A-R-V-T\src\vdom\patch.js", "JavaScript", 0, 37, 0, 0, 2, 6, 45
"d:\VUE-TEM-A-R-V-T\src\vdom\vnode.js", "JavaScript", 0, 18, 0, 0, 1, 3, 22
"Total", "-", 41, 848, 20, 138, 118, 285, 1450